Season,Date,WL,Opp,ScoreTm,ScoreOpp,Offense1stD,OffenseTotYd,OffensePassY,OffenseRushY,OffenseTO,Defense1stD,DefenseTotYd,DefensePassY,DefenseRushY,DefenseTO,Expected PointsOffense,Expected PointsDefense,Expected PointsSp. Tms
2012,9-Sep,L,Arizona Cardinals,16,20,18,254,139,115,2,18,253,210,43,2,-9.49,4.9,1.82
2012,16-Sep,W,Dallas Cowboys,27,7,20,315,133,182,,17,296,247,49,2,5.89,3.37,9.28
2012,24-Sep,W,Green Bay Packers,14,12,14,238,111,127,,22,268,184,84,,0.56,-2.33,3.33
2012,30-Sep,L,St. Louis Rams,13,19,19,319,140,179,3,15,286,211,75,1,-6.87,3.82,-2.06
2012,7-Oct,W,Carolina Panthers,16,12,17,310,212,98,3,13,190,108,82,2,-6.76,20.26,-5
2012,14-Oct,W,New England Patriots,24,23,17,368,283,85,2,26,475,388,87,2,4.31,-7.79,1.97
2012,18-Oct,L,San Francisco 49ers,6,13,13,251,115,136,1,18,313,138,175,1,-8.42,0.14,-2.18
2012,28-Oct,L,Detroit Lions,24,28,21,369,236,133,2,26,415,331,84,1,14.46,-20.15,0.43
2012,4-Nov,W,Minnesota Vikings,30,20,28,385,190,195,,16,287,44,243,2,19.94,-4.22,-2.73
2012,11-Nov,W,New York Jets,28,7,20,363,189,174,2,11,185,101,84,3,1.35,17.97,4.31
2012,25-Nov,L,Miami Dolphins,21,24,16,312,216,96,,23,435,246,189,1,5.06,-17.25,9.65
2012,2-Dec,W,Chicago Bears,23,17,25,459,283,176,1,22,365,233,132,,14.55,-10.51,-0.3
2012,9-Dec,W,Arizona Cardinals,58,0,22,493,209,284,1,10,154,111,43,8,16.75,37.39,-9.64
2012,16-Dec,W,Buffalo Bills,50,17,22,466,196,270,,21,333,215,118,3,25.18,13,-4.79
2012,23-Dec,W,San Francisco 49ers,42,13,22,346,170,176,1,17,313,231,82,2,19.69,1.44,5.09
2012,30-Dec,W,St. Louis Rams,20,13,17,362,209,153,,20,331,252,79,1,9.81,-4.43,1.76
2012,6-Jan,W,Washington Redskins,24,14,22,380,156,224,1,15,203,99,104,2,6.2,9.36,-2.26
2012,13-Jan,L,Atlanta Falcons,28,30,28,491,368,123,2,24,417,250,167,2,16.85,-17.64,0.63
2013,8-Sep,W,Carolina Panthers,12,7,18,370,300,70,1,17,253,119,134,2,2.56,-3.41,7.04
2013,15-Sep,W,San Francisco 49ers,29,3,19,290,118,172,1,12,207,107,100,5,-2.01,25.9,3.35
2013,22-Sep,W,Jacksonville Jaguars,45,17,28,479,323,156,2,17,265,214,51,3,17.42,14.72,-2.93
2013,29-Sep,W,Houston Texans,23,20,15,270,91,179,2,29,476,325,151,3,-8.09,2.11,6.86
2013,6-Oct,L,Indianapolis Colts,28,34,21,423,205,218,2,20,317,208,109,2,5.27,-11.14,-3.68
2013,13-Oct,W,Tennessee Titans,20,13,24,404,253,151,2,13,223,157,66,2,-1.68,8.95,0.52
2013,17-Oct,W,Arizona Cardinals,34,22,21,344,209,135,2,22,234,204,30,2,-5.21,13.62,0.67
2013,28-Oct,W,St. Louis Rams,14,9,7,135,91,44,,23,339,139,200,2,-8.93,8.8,3.02
2013,3-Nov,W,Tampa Bay Buccaneers,27,24,26,415,217,198,3,24,350,145,205,,13.56,-12.18,-1.06
2013,10-Nov,W,Atlanta Falcons,33,10,25,490,279,211,,16,226,162,64,1,23.02,-1.69,-0.11
2013,17-Nov,W,Minnesota Vikings,41,20,16,323,230,93,,19,336,204,132,4,9.06,10.84,1.76
2013,2-Dec,W,New Orleans Saints,34,7,23,429,302,127,,12,188,144,44,1,16.74,16.45,-6.31
2013,8-Dec,L,San Francisco 49ers,17,19,13,264,178,86,1,19,318,155,163,1,2.16,0.82,-6.78
2013,15-Dec,W,New York Giants,23,0,21,327,193,134,1,12,181,156,25,5,-2,24.75,0.46
2013,22-Dec,L,Arizona Cardinals,10,17,10,192,89,103,2,16,307,168,139,4,-14.76,13,-5.44
2013,29-Dec,W,St. Louis Rams,27,9,20,269,158,111,,11,158,145,13,2,1.54,18.54,-1.28
2013,11-Jan,W,New Orleans Saints,23,15,13,277,103,174,,25,409,301,108,1,0.52,1.25,6.46
2013,19-Jan,W,San Francisco 49ers,23,17,14,308,193,115,1,16,308,147,161,3,-6.2,2.26,7.65
2013,2-Feb,W,Denver Broncos,43,8,17,341,206,135,,18,306,279,27,4,7.18,16.32,9.66
2014,4-Sep,W,Green Bay Packers,36,16,25,398,191,207,1,19,255,175,80,1,18.24,1,-0.29
2014,14-Sep,L,San Diego Chargers,21,30,14,288,180,108,1,26,377,276,101,,8.54,-12.21,-3.52
2014,21-Sep,W,Denver Broncos,26,20,26,384,255,129,1,20,332,296,36,2,2.88,8.27,-5.15
2014,6-Oct,W,Washington Redskins,27,17,20,403,178,225,,14,307,275,32,,9.73,-3.55,2.71
2014,12-Oct,L,Dallas Cowboys,23,30,9,206,126,80,1,23,401,239,162,2,-8.6,-13.25,12.84
2014,19-Oct,L,St. Louis Rams,26,28,25,463,292,171,,18,275,173,102,,17.4,-13.21,-8.09
2014,26-Oct,W,Carolina Panthers,13,9,19,310,191,119,2,17,266,152,114,2,-0.83,9.35,-0.13
2014,2-Nov,W,Oakland Raiders,30,24,21,326,177,149,,17,226,189,37,3,0.2,9.4,-2.33
2014,9-Nov,W,New York Giants,38,17,27,510,160,350,3,20,324,270,54,2,23.2,1.57,-1.24
2014,16-Nov,L,Kansas City Chiefs,20,24,25,372,168,204,,20,298,108,190,2,3.78,-8.11,-2.54
2014,23-Nov,W,Arizona Cardinals,19,3,16,293,169,124,,12,204,140,64,1,1.42,9.22,10.24
2014,27-Nov,W,San Francisco 49ers,19,3,16,379,222,157,,16,164,100,64,3,1.22,7.67,2.93
2014,7-Dec,W,Philadelphia Eagles,24,14,28,440,252,188,2,9,139,82,57,2,6.79,13.24,-5.36
2014,14-Dec,W,San Francisco 49ers,17,7,18,290,138,152,1,14,245,105,140,,5.13,4.13,1.75
2014,21-Dec,W,Arizona Cardinals,35,6,23,596,329,267,,17,216,187,29,1,28.01,15.05,-13.23
2014,28-Dec,W,St. Louis Rams,20,6,17,354,222,132,2,15,245,203,42,3,-7.33,26.12,-4.14
2014,10-Jan,W,Carolina Panthers,31,17,16,348,248,100,,21,362,230,132,3,13.2,1.93,1.18
2014,18-Jan,W,Green Bay Packers,28,22,20,397,203,194,5,19,306,171,135,2,2.03,7.48,-5.58
